You have sailed from England around Cape Horn to the deep Peruvian jungle in search of ancient Incan Treasure. Your local guide points you towards an area of dense trees and tells you "The treasure can be found in a hidden temple deep in the rainforest." He cannot lead you to it since the tribesman will attack anyone who comes close to the temple containing the treasure. You should start looking for it now so you can return before it is dark.

Jungle Treasure
An Interactive Fiction by gbricker19
Release 1 / Serial number 190422 / Inform 7 build 6M62 (I6/v6.33 lib 6/12N) SD

Dock
Behind you is the boat that you came here on and the rest of its crew. To the east is Jungle.

You can see a backpack (closed) here.

>e
Jungle
All around you is the Jungle. To the west is the dock. You can make out paths to the east and south.

>e
Jungle
All around you is the Jungle. To the east there appears to be a stone structure but in front of it is a man wearing a mask,he does not look too friendly. You can make out paths to the west and south.

You can see Tribesman here.

>e
The Tribesman blocks your way into the Temple, as you try to move past he pushes you roughly away from the entrance. Your health has been decreased by 10. Your helath is 100

>i
You don't seem to have anything at the moment.
(Health: 90)

* * *

>e
The Tribesman blocks your way into the Temple, as you try to move past he pushes you roughly away from the entrance. Your health has been decreased by 10. Your helath is 100

>w
Jungle
All around you is the Jungle. To your east You can make out paths to the west and south.

>e
Temple entrance

>w
Jungle
All around you is the Jungle. To your east You can make out paths to the west and south.

* * *

>e
Temple entrance

>sw
You can't go that way.

>se
Hallway

>nw
Temple entrance

>w
Jungle
All around you is the Jungle. To your east You can make out paths to the west and south.

* * *

>e
Temple entrance

>se
Hallway

>sw
Treasure Vault

>w
Secret Exit

>n
Jungle
All around you is the Jungle. You can make out paths to the west and north.

* * *

>e
Jungle
All around you is the Jungle. To the east there appears to be a stone structure but in front of it is a man wearing a mask,he does not look too friendly. You can make out paths to the west and south.

You can see Tribesman here.

>s
Jungle
All around you is the Jungle. You can make out paths to the west and north.

You can see Purple Flower here.

>s
You can't go that way.

>hehe
Temple entrance
As you enter the temple the door slams down behind you trapping you in a block of rock. A little light coming in from holes in the roof allows you to make out buttons and a painting on one of the walls.

>haha
Hallway

>sw
Treasure Vault
You can see Gold Totem here.

>w
secret exit

>n
Jungle
All around you is the Jungle. You can make out paths to the west and north.

You can see Purple Flower here.

>s
You can't go that way.

>hehe
Temple entrance
 A little light coming in from holes in the roof allows you to make out buttons and a painting on one of the walls.

* * *

>s
You can't go that way.

>n
Jungle
All around you is the Jungle. You can make out paths to the west and north.

You can see Purple Flower here.

>s
Secret Exit

>n
Jungle
All around you is the Jungle. You can make out paths to the west and north.

You can see Purple Flower here.

* * *

>s
You can't go that way.

>s
You can't go that way.

>haha
Hallway

>hehe
Temple entrance
As you enter the temple the door slams down behind you trapping you in a block of rock. A little light coming in from holes in the roof allows you to make out buttons and a painting on one of the walls.

* * *

>s
You can't go that way.

>rules
Rules tracing now switched on. Type "rules off" to switch it off again, or "rules all" to include even rules which do not apply.

>s
[Rule "declare everything initially unmentioned rule" applies.]
[Rule "standard set going variables rule" applies.]
[Rule "announce items from multiple object lists rule" applies.]
[Rule "set pronouns from items from multiple object lists rule" applies.]
[Rule "before stage rule" applies.]
[Rule "instead stage rule" applies.]
[Rule "investigate player's awareness before action rule" applies.]
[Rule "player aware of his own actions rule" applies.]
[Rule "check stage rule" applies.]
[Rule "can't travel in what's not a vehicle rule" applies.]
[Rule "can't go through undescribed doors rule" applies.]
[Rule "can't go through closed doors rule" applies.]
[Rule "determine map connection rule" applies.]
[Rule "can't go that way rule" applies.]
You can't go that way.

[Rule "A first turn sequence rule" applies.]
[Rule "every turn stage rule" applies.]
[Rule "an every turn rule" applies.]
[Rule "an every turn rule" applies.]
[Rule "An every turn rule" applies.]
[Rule "An every turn rule" applies.]
[Rule "A last turn sequence rule" applies.]
[Rule "notify score changes rule" applies.]

* * *

>e
Jungle
All around you is the Jungle. To the west is the dock. You can make out paths to the east and south.

>hehe
Temple entrance
As you enter the temple the door slams down behind you trapping you in a block of rock. A little light coming in from holes in the roof allows you to make out buttons and a painting on one of the walls.

>press pork
The pork button is pressed down and remains in that position after you lift your hand off.

>press wind
The wind button is pressed down and remains in that position after you lift your hand off.

>press storm
The storm button is pressed down and remains in that position after you lift your hand off.

>e
You can't go that way.

>w
You can't go that way.

>e
You can't go that way.

* * *

>e
Jungle
All around you is the Jungle. To the west is the dock. You can make out paths to the east and south.

>s
Jungle
All around you is the Jungle. You can make out paths to the east and north.

>e
Jungle
All around you is the Jungle. You can make out paths to the west and north.

>s
You can't go that way.

>n
Jungle
All around you is the Jungle. To the east there appears to be a stone structure but in front of it is a man wearing a mask,he does not look too friendly. You can make out paths to the west and south.

>e
Temple entrance

>e
You can't go that way.

>se
Hallway

* * *

>sw
Treasure Vault

>w
secret exit

>n
Jungle
All around you is the Jungle. You can make out paths to the west and north.

>e
You can't go that way.

>n
Jungle
All around you is the Jungle. To the east there appears to be a stone structure but in front of it is a man wearing a mask,he does not look too friendly. You can make out paths to the west and south.

>w
Jungle
All around you is the Jungle. To the west is the dock. You can make out paths to the east and south.

>w
Dock
Behind you is the boat that you came here on and the rest of its crew. To the east is Jungle.

You can see a backpack (closed) here.

>open backpack
You open the backpack, revealing Gloves and Machete.

>take all
backpack: Taken.
Gloves: Taken.
Machete: Taken.

>put on gloves
You put on Gloves.

* * *

>e
Jungle
All around you is the Jungle. To the west is the dock. You can make out paths to the east and south.

>take flower
You died from touching a poisonous flower!

    *** The End ***

Would you like to RESTART, RESTORE a saved game, QUIT or UNDO the last command?

>restart
You have sailed from England around Cape Horn to the deep Peruvian jungle in search of ancient Incan Treasure. Your local guide points you towards an area of dense trees and tells you "The treasure can be found in a hidden temple deep in the rainforest." He can not lead you to it since the tribesman will attack anyone who comes close to the temple containing the treasure. You should start looking for it now so you can return before it is dark.

Jungle Treasure
An Interactive Fiction by gbricker19
Release 1 / Serial number 190401 / Inform 7 build 6M62 (I6/v6.33 lib 6/12N) SD

Dock
Behind you is the boat that you came here on and the rest of its crew. To the east is Jungle.

You can see a backpack (closed) here.

>open backpack
You open the backpack, revealing Gloves and Machete.

>tkae gloves
That's not a verb I recognise.

>take gloves
Taken.

>e
Jungle
All around you is the Jungle. To the west is the dock. You can make out paths to the east and south.

You can see Purple Flower here.

>take flower
You died from touching a poisonous flower!

    *** The End ***

Would you like to RESTART, RESTORE a saved game, QUIT or UNDO the last command?

>undo
Jungle
[Previous turn undone.]

>put on gloves
You put on Gloves.

>take flower
Taken.

* * *

>haha
Hallway
A fairly bare hallway with piles of sand strewn around.

>nw
Temple entrance
As you enter the temple the door slams down behind you trapping you in a block of rock. A little light coming in from holes in the roof allows you to make out buttons and a painting on one of the walls.

>se
Hallway

>nw
Temple entrance
 A little light coming in from holes in the roof allows you to make out buttons and a painting on one of the walls.

* * *

>hehe
Temple entrance
As you enter the temple the door slams down behind you trapping you in a block of rock. A little light coming in from holes in the roof allows you to make out buttons and a painting on one of the walls.

* * *

>s
You can't go that way.

>n
Jungle
All around you is the Jungle. To the east there appears to be a stone structure but in front of it is a man wearing a mask,he does not look too friendly. You can make out paths to the west and south.

You can see Tribesman here.

>e
The door came down behind you when you entered and continues to block the entrance to the temple.

* * *

>s
You can't go that way.

>increase TE by 1
That's not a verb I recognise.

* * *

>e
You can't go that way.

>se
Hallway
A fairly bare hallway with piles of sand strewn around.

>nw
Temple entrance
 A little light coming in from holes in the roof allows you to make out buttons and a painting on one of the walls.

* * *

>hehe
Temple entrance
As you enter the temple the door slams down behind you trapping you in a block of rock. A little light coming in from holes in the roof allows you to make out buttons and a painting on one of the walls.

>press storm
The storm button is pressed down and remains in that position after you lift your hand off.

>press pork
The pork button is pressed down and remains in that position after you lift your hand off.

>press wind
The wind button is pressed down and remains in that position after you lift your hand off.

Suddenly the room begins to shake and a large stone door to your southeast begins to move out of the way revealing a hallway deeper into the temple.

>se
Hallway
A fairly bare hallway with piles of sand strewn around.

>sw
Treasure Vault
A decorated vault with a Golden Totem on a pedestal in the middle of the room. This is just the type of treasure you have been looking for!

You can see Gold Totem here.

>take totem
Taken.

>undo
Treasure Vault
[Previous turn undone.]

* * *

>press storm
The storm button is pressed down and remains in that position after you lift your hand off.

>press winf
You can't see any such thing.

>press wind
The wind button is pressed down and remains in that position after you lift your hand off.

>press pork
The pork button is pressed down and remains in that position after you lift your hand off.

Suddenly the room begins to shake and a large stone door to your southeast begins to move out of the way revealing a hallway deeper into the temple.

>se
Hallway
Suddenly the room begins to shake and a large stone door to your southeast begins to move out of the way revealing a hallway deeper into the temple.

>nw
Temple entrance
As you enter the temple the door slams down behind you trapping you in a block of rock. A little light coming in from holes in the roof allows you to make out buttons and a painting on one of the walls.

Suddenly the room begins to shake and a large stone door to your southeast begins to move out of the way revealing a hallway deeper into the temple.

>se
Hallway
Suddenly the room begins to shake and a large stone door to your southeast begins to move out of the way revealing a hallway deeper into the temple.

* * *

>hehe
Temple entrance
As you enter the temple the door slams down behind you trapping you in a block of rock. A little light coming in from holes in the roof allows you to make out buttons and a painting on one of the walls.

>x painting
It seems to be a key for whatever buttons you have to press in the painting it depicts a crashing wave, a firepit and spit on the beach, and a bird flying in the sky

>x buttons
There are five buttons on the wall a pork button, a wind button, a volcano button, a spear button, a storm button, and a red button with a looped arrow, maybe it's the reset button. To press a button say press "name" button.

>press storm button
The storm button is pressed down and remains in that position after you lift your hand off.

>press wind button
The wind button is pressed down and remains in that position after you lift your hand off.

>press volcano
The volcano button is pressed down and remains in that position after you lift your hand off.

>press volcano
The volcano button lifts up to the unpressed position

>press pork
The pork button is pressed down and remains in that position after you lift your hand off.

>se
Hallway

* * *

>i
You are carrying nothing.

* * *

>open back pack
You open the backpack, revealing Gloves, Machete and Dart.

>take dart
Taken.

>throw dart
Dropped.

>take dart
Taken.

* * *

>open backpack
You open the backpack, revealing Gloves, Machete, Dart x 5 and Sandbag(empty).

>take dart
Taken.

>e
Jungle
All around you is the Jungle. To the west is the dock. You can make out paths to the east and south.

* * *

>e
Jungle
All around you is the Jungle. To the east there appears to be a stone structure but in front of it is a man wearing a mask,he does not look too friendly. You can make out paths to the west and south.

You can see Tribesman here.

>throw dart at tribesman
You throw the dart at the Tribesman but he simply pulls it out of his skin as if it were a mosquito sting. The Tribesman's health has been decreased by 5. His current health is 95.

>e
The Tribesman blocks your way into the Temple, as you try to move past he pushes you roughly away from the entrance. Your health has been decreased by 10. Your health is 90

* * *

>throw dart at tribesman
You throw the dart at the Tribesman but he simply pulls it out of his skin as if it were a mosquito sting. The Tribesman's health has been decreased by 5. His current health is 95.

>i
You are carrying: 
Dart x 4
(Health: 100)

>throw dart at tribesman
You throw the dart at the Tribesman but he simply pulls it out of his skin as if it were a mosquito sting. The Tribesman's health has been decreased by 5. His current health is 90.

>throw dart at tribesman
You throw the dart at the Tribesman but he simply pulls it out of his skin as if it were a mosquito sting. The Tribesman's health has been decreased by 5. His current health is 85.

>i
You are carrying: 
Dart x 2
(Health: 100)

>i
You are carrying: 
Dart x 2
(Health: 100)

>throw dart at tribesman
You throw the dart at the Tribesman but he simply pulls it out of his skin as if it were a mosquito sting. The Tribesman's health has been decreased by 5. His current health is 80.

>throw dart at tribesman
You throw the dart at the Tribesman but he simply pulls it out of his skin as if it were a mosquito sting. The Tribesman's health has been decreased by 5. His current health is 75.

>i
You are carrying: 
Dart x 0
(Health: 100)

>throw dart at tribesman
You have no darts left

* * *

>take dart
Taken.

>i
You are carrying: 
Dart x 5
(Health: 100)

>throw dart
Dropped.

>i
You don't seem to have anything at the moment.
(Health: 100)

>take all
Dart x 5: Taken.
backpack: Taken.
Gloves: Taken.
Machete: Taken.

* * *

>take dart
Taken.

>e
Jungle
All around you is the Jungle. To the west is the dock. You can make out paths to the east and south.

You can see Purple Flower here.

>throw dart
Dropped.

* * *

>take dart
Taken.

>e
Jungle
All around you is the Jungle. To the east there appears to be a stone structure but in front of it is a man wearing a mask,he does not look too friendly. You can make out paths to the west and south.

You can see Tribesman here.

>throw dart
Dropped.

>throw dart
Dart is already here.

>e
Jungle
All around you is the Jungle. To the west is the dock. You can make out paths to the east and south.

You can see Purple Flower here.

>throw dart
You can't see any such thing.

>w
Dock
Behind you is the boat that you came here on and the rest of its crew. To the east is Jungle.

You can see Dart and a backpack (in which are Gloves and Machete) here.

* * *

>take dart
Taken.

>wear gloves
(first taking Gloves)
You put on Gloves.

>e
Jungle
All around you is the Jungle. To the west is the dock. You can make out paths to the east and south.

* * *

>s
Jungle
All around you is the Jungle. You can make out paths to the west and north.

You can see Purple Flower here.

>w
Jungle
All around you is the Jungle. You can make out paths to the east and north.

>e
Jungle
All around you is the Jungle. You can make out paths to the west and north.

You can see Purple Flower here.

>n
Jungle
All around you is the Jungle. To the east there appears to be a stone structure but in front of it is a man wearing a mask,he does not look too friendly. You can make out paths to the west and south.

You can see Tribesman here.

>e
The Tribesman blocks your way into the Temple, as you try to move past he pushes you roughly away from the entrance. Your health has been decreased by 10. Your current health is 90.

>s
Jungle
All around you is the Jungle. You can make out paths to the west and north.

You can see Purple Flower here.

>take purple flowere
I only understood you as far as wanting to take Purple Flower.

>take purple flower
Taken.

>combine lower with dart
You can't see any such thing.

>combine flower with dart
you coat the dart in the toxins of the flower andcreate a poisonous dart.

>n
Jungle
All around you is the Jungle. To the east there appears to be a stone structure but in front of it is a man wearing a mask,he does not look too friendly. You can make out paths to the west and south.

You can see Tribesman here.

>throw dart at tribesman
You throw the poisonous dart at the Tribesman but he pulls it out of his skin as if it were a mosquito sting. But after a few seconds he drops to the floor.

>e
Temple entrance

>w
Jungle
All around you is the Jungle. To the east there appears to be a stone structure but in front of it is a man wearing a mask,he does not look too friendly. You can make out paths to the west and south.

You can see Poisonous Dart and Tribesman's dead body here.

* * *

>open backpack
You open the backpack, revealing Gloves, Machete, Dart x 5 and Sandbag(empty).

>take gloves
Taken.

* * *

>e
Jungle
All around you is the Jungle. To the west is the dock. You can make out paths to the east and south.

You can see Purple Flower here.

>take lower
You can't see any such thing.

>take flower
Taken.

>put ongloves
You can't see any such thing.

>put on gloves
You put on Gloves.

* * *

>open backpack
You open the backpack, revealing Gloves, Machete, Dart x 5 and Sandbag(empty).

>take machete
Taken.

>e
Jungle
All around you is the Jungle. To the west is the dock. You can make out paths to the east and south.

>e
Jungle
All around you is the Jungle. To the east there appears to be a stone structure but in front of it is a large tribesman, he does not look too friendly. You can make out paths to the west and south.

You can see Tribesman here.

>attac tribesman
That's not a verb I recognise.

>attack tribesman
Violence isn't the answer to this one.

>attack tibesman with machete
You can't see any such thing.

>attack tribesman with machete
By hitting the tribesman with machete you have angered him greatly your blow lands dealing 30 damage. The Tribesman's current health is 80.
 He swings back at you with his spear and deals 40 damage. Your current health is 60.

>attack tribesman with machete
By hitting the tribesman with machete you have angered him greatly your blow lands dealing 30 damage. The Tribesman's current health is 60.
 He swings back at you with his spear and deals 40 damage. Your current health is 20.

>attack tribesman with machete
By hitting the tribesman with machete you have angered him greatly your blow lands dealing 30 damage. The Tribesman's current health is 40.
 He swings back at you with his spear and deals 40 damage. Your current health is -20.

>attack tribesman with machete
By hitting the tribesman with machete you have angered him greatly your blow lands dealing 30 damage. The Tribesman's current health is 20.
 He swings back at you with his spear and deals 40 damage. Your current health is -60.

>i
You are carrying: 
Machete
(Health: -60)

* * *

>e
Jungle
All around you is the Jungle. To the east there appears to be a stone structure but in front of it is a large tribesman, he does not look too friendly. You can make out paths to the west and south.

You can see Tribesman here.

>attack tibesman with machete
You can't see any such thing.

>attack tribesman with machete
By hitting the tribesman with machete you have angered him greatly your blow lands dealing 20 damage. The Tribesman's current health is 80.
 He swings back at you with his spear and deals 40 damage. Your current health is 60.

>attack tribesman with machete
By hitting the tribesman with machete you have angered him greatly your blow lands dealing 20 damage. The Tribesman's current health is 60.
 He swings back at you with his spear and deals 40 damage. Your current health is 20.

>attack tribesman with machete
By hitting the tribesman with machete you have angered him greatly your blow lands dealing 20 damage. The Tribesman's current health is 40.
 He swings back at you with his spear and deals 40 damage. Your current health is -20.

You have died

    *** The End ***

Would you like to RESTART, RESTORE a saved game, QUIT or UNDO the last command?

* * *

>open backpack
You open the backpack, revealing Gloves, Machete, Dart x 5 and Sandbag(empty).

>take sandbag
Taken.

>haha
Hallway
A fairly bare hallway with piles of sand strewn around.

>fill snadbag with sand
You can't see any such thing.

>fill sandbag with sand
You take the sand from the hallway floor and stuff it into the bag, now the bag is full

>sw
Treasure Vault
A decorated vault with a Golden Totem on a pedestal in the middle of the room. This is just the type of treasure you have been looking for!

You can see Gold Totem here.

>take totem
The pedestal begins to rise to the ceiling until the floor from underneath you drops out and you plummet to your presumed death.

    *** The End ***

Would you like to RESTART, RESTORE a saved game, QUIT or UNDO the last command?

>undo
Treasure Vault
[Previous turn undone.]

>switch sandbag with totem
You switch the Sandbag with the Totem and nothing happens, you should get out of here before any other crazy things happen

>w
secret exit
A room overhanging the jungle outside the temple, once you exit the temple you will not be able to return. Make sure you have everything you could want beore leaving.

* * *

>haha
Hallway
A fairly bare hallway with piles of sand strewn around.

>sw
Treasure Vault
A decorated vault with a Golden Totem on a pedestal in the middle of the room. This is just the type of treasure you have been looking for!

You can see Gold Totem here.

>switch sandbag with totem
You switched the empty sandbag for the totem but the empty sandbag was not nearly close to the same weight as the totem and the pedestal began to rise to the ceiling until the floor from underneath you dropped out and you plummeted to your presumed death.

    *** The End ***

Would you like to RESTART, RESTORE a saved game, QUIT or UNDO the last command?

* * *

>rules
Rules tracing now switched on. Type "rules off" to switch it off again, or "rules all" to include even rules which do not apply.

>open backpack
[Rule "declare everything initially unmentioned rule" applies.]
[Rule "announce items from multiple object lists rule" applies.]
[Rule "set pronouns from items from multiple object lists rule" applies.]
[Rule "before stage rule" applies.]
[Rule "instead stage rule" applies.]
[Rule "investigate player's awareness before action rule" applies.]
[Rule "player aware of his own actions rule" applies.]
[Rule "check stage rule" applies.]
[Rule "can't open unless openable rule" applies.]
[Rule "can't open what's locked rule" applies.]
[Rule "can't open what's already open rule" applies.]
[Rule "carry out stage rule" applies.]
[Rule "standard opening rule" applies.]
[Rule "after stage rule" applies.]
[Rule "investigate player's awareness after action rule" applies.]
[Rule "report stage rule" applies.]
[Rule "reveal any newly visible interior rule" applies.]
You open the backpack, revealing Gloves, Machete and Dart.
[Rule "last specific action-processing rule" applies.]

[Rule "A first turn sequence rule" applies.]
[Rule "every turn stage rule" applies.]
[Rule "A last turn sequence rule" applies.]
[Rule "notify score changes rule" applies.]

>take dart
[Rule "declare everything initially unmentioned rule" applies.]
[Rule "announce items from multiple object lists rule" applies.]
[Rule "set pronouns from items from multiple object lists rule" applies.]
[Rule "before stage rule" applies.]
[Rule "instead stage rule" applies.]
[Rule "investigate player's awareness before action rule" applies.]
[Rule "player aware of his own actions rule" applies.]
[Rule "check stage rule" applies.]
[Rule "can't take yourself rule" applies.]
[Rule "can't take other people rule" applies.]
[Rule "can't take component parts rule" applies.]
[Rule "can't take people's possessions rule" applies.]
[Rule "can't take items out of play rule" applies.]
[Rule "can't take what you're inside rule" applies.]
[Rule "can't take what's already taken rule" applies.]
[Rule "can't take scenery rule" applies.]
[Rule "can only take things rule" applies.]
[Rule "can't take what's fixed in place rule" applies.]
[Rule "use player's holdall to avoid exceeding carrying capacity rule" applies.]
[Rule "can't exceed carrying capacity rule" applies.]
[Rule "carry out stage rule" applies.]
[Rule "standard taking rule" applies.]
[Rule "after stage rule" applies.]
[Rule "investigate player's awareness after action rule" applies.]
[Rule "report stage rule" applies.]
[Rule "standard report taking rule" applies.]
Taken.
[Rule "last specific action-processing rule" applies.]

[Rule "A first turn sequence rule" applies.]
[Rule "every turn stage rule" applies.]
[Rule "A last turn sequence rule" applies.]
[Rule "notify score changes rule" applies.]

>throw dart
[Rule "declare everything initially unmentioned rule" applies.]
[Rule "announce items from multiple object lists rule" applies.]
[Rule "set pronouns from items from multiple object lists rule" applies.]
[Rule "before stage rule" applies.]
[Rule "instead stage rule" applies.]
[Rule "investigate player's awareness before action rule" applies.]
[Rule "player aware of his own actions rule" applies.]
[Rule "check stage rule" applies.]
[Rule "can't drop yourself rule" applies.]
[Rule "can't drop what's already dropped rule" applies.]
[Rule "can't drop what's not held rule" applies.]
[Rule "can't drop clothes being worn rule" applies.]
[Rule "can't drop if this exceeds carrying capacity rule" applies.]
[Rule "carry out stage rule" applies.]
[Rule "standard dropping rule" applies.]
[Rule "after stage rule" applies.]
[Rule "investigate player's awareness after action rule" applies.]
[Rule "report stage rule" applies.]
[Rule "standard report dropping rule" applies.]
Dropped.
[Rule "last specific action-processing rule" applies.]

[Rule "A first turn sequence rule" applies.]
[Rule "every turn stage rule" applies.]
[Rule "A last turn sequence rule" applies.]
[Rule "notify score changes rule" applies.]

* * *

>take all
Hmm if the game was that easy it wouldn't be worth playing

* * *

>take backpack
Taken.

>haha
Hallway

* * *

>sw
Treasure Vault
You can see Gold Totem here.

>se
You can't go that way.

>ne
Hallway

>fill sandbag with sand
You can't see any such thing.

>pour sand into sandbag
You can't see any such thing.

>put sand in sandbag
You can't see any such thing.

>open sandbag
You can't see any such thing.

>open backpack
You open the backpack, revealing Gloves, Machete, Dart x 5 and sandbag.

>take sandbag
Taken.

>fill sandbag with sand
You take the sand from the hallway floor and stuff it into the bag, now the bag is full

>undo
Hallway
[Previous turn undone.]

>undo
Hallway
[Previous turn undone.]

>fill sandbag with sand
You take the sand from the hallway floor and stuff it into the bag, now the bag is full

>sw
Treasure Vault
You can see Gold Totem here.

* * *

>take backpack
Taken.

>i
You are carrying:
  a backpack (closed)

>open backpack
You open the backpack, revealing Gloves.

>put on gloves
(first taking Gloves)
You put on Gloves.

* * *

>throw dart
You can't see any such thing.

>open backpack
You open the backpack, revealing Gloves, Machete and Dart x 5.

>take dart
Taken.

* * *

>i
You don't seem to have anything at the moment.
(Health: 100)

>taek dart
That's not a verb I recognise.

>take dart
Taken.

* * *

>throw dart at tribesman
You throw the dart at the Tribesman but he simply pulls it out of his skin as if it were a mosquito sting. The Tribesman's health has been decreased by 5. His current health is 95.

>i
You don't seem to have anything at the moment.
(Health: 100)